....................
.###............###.
.###............###.
.###............###.
....................
....................
....................
....................
....................
....................
........###.........
....................
....................
....................
....................
....................
.###............###.
.###............###.
.###............###.
....................