....................
##..................
.##.................
..##................
...##...............
....##..............
.....##.............
......##............
.......##...........
....................
....................
...........##.......
............##......
.............##.....
..............##....
...............##...
................##..
.................##.
..................##
....................